##########
#........#
#..##....#
#..P.....#
##########